111111111111111111111111111111111
1P0000000000000000000000000000001
100000011111000000011111000000001
100000111111000000111111100000001
100001100011000001100C01100000001
100011000011000000000011000000001
100111111111000000000110000000001
10000000C111000000001100000000001
1000000001110000000110C0000000001
100000000111000000111111000000001
1000000000000000000000000000000E1
111111111111111111111111111111111